##########
#...#....#
#........#
#####....#
#........#
#....#####
#........#
####...###
#@.......#
##########
